0,0,0,0,0,0,0,0,0,0,0,0,0,0,0,0,0,0,0,0,0,0,0,0,0,0,0,0,0,0,0,0,0,0,0,0,0,0,0,0
0,4,4,4,4,4,4,4,4,4,4,4,4,4,4,4,4,4,4,0,0,4,4,4,4,4,4,4,4,4,4,4,4,4,4,4,4,4,4,0
0,4,1,1,1,1,1,1,1,1,1,1,1,1,1,1,1,1,2,3,3,2,1,1,1,1,1,1,1,1,1,1,1,1,1,1,1,1,4,0
0,4,1,2,3,3,2,1,2,3,3,3,2,1,2,3,3,2,1,1,1,1,2,3,3,2,1,2,3,3,3,2,1,2,3,3,2,1,4,0
0,4,1,3,0,0,3,1,3,0,0,0,3,1,3,0,0,3,1,1,1,1,3,0,0,3,1,3,0,0,0,3,1,3,0,0,3,1,4,0
0,4,1,2,3,3,2,1,2,3,3,3,2,1,2,3,3,2,1,1,1,1,2,3,3,2,1,2,3,3,3,2,1,2,3,3,2,1,4,0
0,4,1,1,1,1,1,1,1,1,1,1,1,1,1,1,1,1,2,3,3,2,1,1,1,1,1,1,1,1,1,1,1,1,1,1,1,1,4,0
0,4,1,2,3,3,2,1,2,3,3,3,2,1,2,3,3,3,3,0,0,3,3,3,3,2,1,2,3,3,3,2,1,2,3,3,2,1,4,0
0,4,1,3,0,0,3,1,3,0,0,0,3,1,3,0,0,0,0,0,0,0,0,0,0,3,1,3,0,0,0,3,1,3,0,0,3,1,4,0
0,4,1,2,3,3,2,1,2,4,0,3,2,1,2,3,3,3,3,3,3,3,3,3,3,2,1,2,4,0,4,2,1,2,3,3,2,1,4,0
0,4,1,1,1,1,1,1,1,3,0,3,1,1,1,1,1,1,1,1,1,1,1,1,1,1,1,1,3,0,3,1,1,1,1,1,1,1,4,0
0,4,1,2,3,2,1,1,1,3,0,4,3,3,3,3,3,3,2,1,1,2,3,3,3,3,3,3,4,0,3,1,1,1,2,3,2,1,4,0
0,4,1,3,0,3,1,1,1,3,0,0,0,0,0,0,0,0,3,1,1,3,0,0,0,0,0,0,0,0,3,1,1,1,3,0,3,1,4,0
0,4,1,3,0,3,1,1,1,2,3,3,3,3,3,3,3,3,2,1,1,2,3,3,3,3,3,3,3,3,2,1,1,1,3,0,3,1,4,0
0,4,1,3,0,3,1,1,1,1,1,1,1,1,1,1,1,1,1,1,1,1,1,1,1,1,1,1,1,1,1,1,1,1,3,0,3,1,4,0
0,4,1,3,0,4,3,3,3,3,3,3,3,3,3,3,2,1,2,3,3,2,1,2,3,3,3,3,3,3,3,3,3,3,4,0,3,1,4,0
0,4,1,3,0,0,0,0,0,0,0,0,0,0,0,0,3,1,3,0,0,3,1,3,0,0,0,0,0,0,0,0,0,0,0,0,3,1,4,0
0,4,1,3,0,4,3,3,3,3,3,4,0,4,3,3,2,1,3,0,0,3,1,2,3,3,4,0,4,3,3,3,3,3,4,0,3,1,4,0
0,4,1,3,0,3,1,1,1,1,1,3,0,3,1,1,1,1,3,0,0,3,1,1,1,1,3,0,3,1,1,1,1,1,3,0,3,1,4,0
0,4,1,3,0,3,1,2,3,2,1,3,0,3,1,1,1,1,3,0,0,3,1,1,1,1,3,0,3,1,1,1,1,1,3,0,3,1,4,0
0,4,1,2,3,2,1,3,0,3,1,2,3,2,1,1,1,1,3,0,0,3,1,1,1,1,2,3,2,1,1,0,1,1,2,3,2,1,4,0
0,4,1,1,1,1,1,3,0,3,1,1,1,1,1,1,1,1,3,0,0,3,1,1,1,1,1,1,1,1,1,0,1,1,1,1,1,1,4,0
0,4,4,4,4,4,4,4,0,4,4,4,4,4,4,0,4,4,4,0,0,4,4,4,0,4,4,4,4,4,4,0,4,4,4,4,4,4,4,0
0,0,0,0,0,0,0,0,0,0,0,0,0,0,0,0,0,0,0,0,0,0,0,0,0,0,0,0,0,0,0,0,0,0,0,0,0,0,0,0
